*            **************************************
*            ** 1 * 2 * 3 * 4 * 5 * 6 * 7 * 8 * 9 *
*            **   *   *   *   *   *   *   *   *   *
*            **   *   *   *   *   *   *   *   *   *
*                                                 *
*                                                 *
***********************************          ******
***********************************          ******
****************                                a * 
****************                             ******
*****************   *   *   *   *   *   *       b *
*****************   *   *   *   *   *   *    ******
***************** i * h * g * f * e * d *       c *
***************************************************
